1111111
100C001
10PE001
1111111
